{
  "MAP_SIZE": 30,
  "groundMap": [
    "##############################",
    "##############################",
    "##############################",
    "##############################",
    "##############################",
    "##############################",
    "##############################",
    "##############################",
    "##############################",
    "##############################",
    "##############################",
    "##############################",
    "##############################",
    "##############################",
    "##############################",
    "##############################",
    "##############################",
    "##############################",
    "##############################",
    "##############################",
    "##############################",
    "##############################",
    "##############################",
    "##############################",
    "##############################",
    "##############################",
    "##############################",
    "##############################",
    "##############################",
    "##############################"
  ],
  "ceilingMap": [
    "##############################",
    "##############################",
    "##############################",
    "##############################",
    "##############################",
    "##############################",
    "##############################",
    "##############################",
    "##############################",
    "##############################",
    "##############################",
    "##############################",
    "##############################",
    "##############################",
    "##############################",
    "##############################",
    "##############################",
    "##############################",
    "##############################",
    "##############################",
    "##############################",
    "##############################",
    "##############################",
    "##############################",
    "##############################",
    "##############################",
    "##############################",
    "##############################",
    "##############################",
    "##############################"
  ],
  "wallMap": [
    "###############D##############",
    "#G#..........#.##..........#G#",
    "#............#..#............#",
    "#............#..#............#",
    "#............#..#............#",
    "#...........#G#.#............#",
    "#............................#",
    "#..###.##..........######....#",
    "#..#....#...............#....#",
    "#..#....#....#.....#....#....#",
    "#..#....#....###...#....#....#",
    "#..##.#.#..........#.#.##....#",
    "#............................#",
    "#............#...............#",
    "#............#..#............#",
    "#............#..#............#",
    "#............#...............#",
    "#............####.....#G#....#",
    "#............................#",
    "#....#########....######.##..#",
    "#....#.......#....#.......#..#",
    "#....#.......#....#.......#..#",
    "#....####..###....##..#####..#",
    "#............................#",
    "#............................#",
    "T............................#",
    "#............................#",
    "#............................#",
    "#G#........................#G#",
    "#####B########GDG####S########"
  ],
  "objectMap": [
    "..............................",
    "..............................",
    ".......E......B...C...........",
    "........F.......D......E......",
    "..............................",
    "....A...........B.......A.....",
    "...........A..................",
    "................C.............",
    ".....B......C........B........",
    ".........................C....",
    ".......C.....B..........C.....",
    "....A................A........",
    "..............................",
    "..............................",
    "...............C..............",
    "..............................",
    "..............................",
    "........A.....................",
    "..............................",
    "..............................",
    "..............................",
    "........................B.....",
    "..............................",
    "..............................",
    ".......A.......P.....A........",
    "..............................",
    "..............................",
    "..............................",
    "..............................",
    ".............................."
  ]
}