{
  "MAP_SIZE": 11,
  "bgm": "https://res.cloudinary.com/dmdpjf8up/video/upload/v1764384182/into_the_graveyard_qwovim.mp3",

  "groundMap": [
    "###########",
    "###########",
    "###########",
    "###########",
    "###########",
    "###########",
    "###########",
    "###########",
    "###########",
    "###########",
    "###########"
  ],

  "ceilingMap": [
    "###########",
    "###########",
    "###########",
    "###########",
    "###########",
    "###########",
    "###########",
    "###########",
    "###########",
    "###########",
    "###########"
  ],

  "wallMap": [
    "#####D#####",
    "####G.G####",
    "##.......##",
    "##.......##",
    "##.......##",
    "##.......##",
    "##.......##",
    "##.......##",
    "##.......##",
    "####S.S####",
    "#####D#####"
  ],

  "objectMap": [
    "...........",
    "...........",
    ".....P.....",
    "...........",
    "...........",
    "...........",
    "...........",
    "...........",
    "...........",
    "...........",
    "..........."
  ],

  "lightMap": [
    "...........",
    "...........",
    "...........",
    "..B..W..B..",
    "...........",
    "..B..W..B..",
    "...........",
    "..B..W..B..",
    "...........",
    "...........",
    "..........."
  ],

  "portalMap": [
    "...........",
    ".....A.....",
    "...........",
    "...........",
    "...........",
    "...........",
    "...........",
    "...........",
    "...........",
    ".....B.....",
    "..........."
  ],

  "portals": {
    "A": {
      "url": "https://termcic.github.io/insect_ecology/godness.json"
    },
    "B": {
      "url": "https://termcic.github.io/insect_ecology/training.json"
    }
  }
}
